EA ./textures/texture1.png



WE	./textures/texture2.png		

NO ./textures/texture5.png 	 	 

 
C	135,206,	 	235 	 


SO 	 		 ./textures/texture4.png 

F 232,	231,201


        0111101111001111111000001
        1000010000110000000111110
        1011000001110000000000001


        0111101111001111111000001
        1000010000110000000111110
        1011000001110000000000001
        1001000000000000000000001
111111111011000001110000000000001
10000000001100000111D11111D111111
01110111111111011100000010001
01110111111111011101010000001
11000000110101011100000010001 11111111111111111111111111111
10000000000000001100000010001 10000000000000001100000010001
10000000000000001101D10010001 1000000000000000110110010001
11000001110101011111011110N01 11011111111111111111111111111
00110111 1110101 101111010001
   11111 1111111 111111111111